NO ./textures/wall_1.xpm
SO ./textures/wall_2.xpm
EA ./textures/wall_3.xpm
WE ./textures/wall_4.xpm
F 255,0,0
C 0,255,255

111111111111111
100000000000001
100000000000001
100000000000001
100000000000001
100000000000001
100000110000001
100000000000001
100000000110001
100000000000001
100000000000001
100000000000001
10N000000000001
100000000000001
111111111111111